11111111111111111
1110001110E111111
010000100000C00P1
11111111111111111