11111111111111111111111111111111111111
10P01C01000000000000000000000000000001
1001100100000000000000000000C000000001
10001000100000000000000000000000000001
10000000000000000000000000001111111101
11111111111111111110000000000011111101
1C00000000000E0000000000000000011111C1
11111111111111111111111111111111111111