11111111111111
1P0000000000E1
10000C00000001
11111111111111
1
1
1
1