1111111111
100P000111
10C000E111
1000000001