111111111111111
10000000000C001
10P00E000000001
100000000000001
100000000C00001
100000000000001
100000000000001
100C00000000001
100000000000C01
111111111111111