111111111111111111111111111111111111111111111111111111111111
100000000000000000C0000000000000000000000000C0000000000000C1
100110000000000000000000000000000000000000000000000000000001
10011100000000000000000000000000000000000000000000P000000001
100111100000000000000000000000000000000000000000000000000001
10000E100000000000000000000000000000000000000000000000000C01
1C11111000000000000000000000C0000000000000000000000000000001
111111111111111111111111111111111111111111111111111111111111