1111111111111111111111111
1P0100C000000000010000001
101001110000C000010000001
1011010000000000000C00001
1000011111111100000000001
1111111111111111111110001
1000000000C0E100000000111
1C11111111111100000011111
1000000000000001111111111
1111111111111111111111111