11111111111111111
1E0111000000000C1
10011000111110111
1C0000000C11000P1
11111111111111111